300000000000022200000000000000000000000000000000000000000000000000003
300000000000000000000000000000000000000220000000000000000000000222223
300000000000000000000000000000000000000000000000000000000000000000003
300002222200000000000000000000000000000000000000000000000022222222003
300000000000000000000000000000000000000000000000000000000000000000003
300000000000000000000022222222222222222222200000000000000000000000003
300000000000000000000000000000000000000000000000000000000000000000003
300000000000000000000000000000000000000000000000000000000000000000003
300000000000000000000000000000000000000000022222222222222222222200003
311111111111111100000000000000000000000000000000000000000000000000003
333333333333333311111111111111111111111111111111111111111111111111113
333333333333333333333333333333333333333333333333333333333333333333333